0,0,0,0,0,0,0,0,0,0,0,0
0,0,0,0,0,0,0,0,0,0,0,0
0,0,10,1,1,1,1,1,1,10,0,0
0,0,10,1,1,1,1,1,1,10,0,0
0,0,10,5,5,5,5,5,5,10,0,0
0,0,10,4,4,4,4,4,4,10,0,0
0,0,10,3,3,3,3,3,3,10,0,0
0,0,10,2,2,2,2,2,2,10,0,0
0,0,10,1,1,1,1,1,1,10,0,0
0,0,10,10,10,10,10,10,10,10,0,0
